      111111111111
      100000000001
 1    100000000001
1N1   100000000001
      100000000001
      100000000001
      100000000001
      100000000001
      111111111111
