
111111111111
100000000001
E00000000001
100000000001
100000000001
100000000001
100000000011
10000000001
111111111111
