111111111111
100000000001
100000000001     S   
100000000001
100000000001       
100000000001
100000000001
100000000001
111111111111
