111111111
100000001
10 000001
100000001
100000001
111111111
