1111N1111111
100000000001
100000000001
100000000001
100000000001
100000000001
100000000001
100000000001
111111111111
