111111111111
100000000001
100000000001
100000000001
100000000001
100000000001
100000000001
100000000001
11111111111E
