111111111111
100000000001
100000000001
100000000001
100000000001
100000000001
100000000011
10000000001N
111111111111
