

NO ./textures/eagle.xpm

SO ./textures/wood.xpm

EA ./textures/redbrick.xpm

WE ./textures/colorstone.xpm

F		   80,		80,		80
C				255			,		80			,			100

1
        1111111111111111111111111
        1000000000110000000000001
        1011000001110000000000001
        1001000000000000000000001
111111111011000001110000000000001
100000000011000001110111101011111
11110111111111011100000010001
11110111111111011101010010101
11000000110101011100000010001
10000000000000001100000010001
10000000000000001101010010001
11000001110101011111011100N0111
11110111 1110101 101111000001
11111111 1111111 111111111111
