
NO ./north_texture

SO ./south_texture

EA ./east_texture

WE ./west_texture


F		   0,		255,		255
C				255			,		255			,			255


111111111
1E0000001
100000001
100000001
1000000001
111111111
