111111111111    1111
100000000001   100001 
100000000001  100S0001
100000000001   100001 
100000000001    1111
100000000001       
100000000001
100000000001
100000000001
111111111111
