111111111
100000001
100000001
100000W01
100000001
 11111111
