1111111111111111111111111111
1000000000000000000000000001
1000000000111111000000000001
1000000001      100000000001
1000000001      100000000001
1000000001      100000000001
1000000001      100000000001
1000000001      100000000001
1000000001      100000000001
1000000001      100000000001
1000000000111111000000000001
1000000000E000000000000000001
1111111111111111111111111111
