                      11
                     1111
					100001
				   10000001
				  1000000001
				 100000000001
				 10000N000001
				  1000000001
				   10000001
					100001
                     1111
                      11
