111111111
100000001
100000001
100000001
100000001
100000001
111111111

            111111111
            100000001
            100000001
            100000001
            1000000N1
            111111111
