111111111111111111111111111111
100001 1000001 1000001 1000011
100001 1000001 1000001 1000011
100001 1000001 1000001 1000011
100001 10000N1 1000001 1000011
111111111111111111111111111111

