           1
         11111
       110000011
      11000000011
      11000000011
      1100000N011
      11111111111
